1211111111111111111111111
1000000000000000000000001
1011101110111011101110111
1010000000000000000000001
1010101010101010101010101
1010101010101010101010101
1010101010101010101010101
1000000000000000000000001
1011111111111111111111101
1000000000000000000000101
1111101110111011101110111
1010000000000000000000001
1011101110111011101110101
1000010001000100010000101
1011101110111011101110111
1010000000001000000000001
1010000000001010101010101
1010000000000010101010101
1011101110111010101010101
1000000000000000000000101
1111111111111000000011101
1000000000000000000010001
1011101110001111111111101
1000000000000000000000001
1111111111111111111111131
