1211111111111111111111111
1001100000111000001100011
1010101110101011101110111
1000000000000000000000001
1101110101111101010101111
1001000100010001000100001
1001111100111111111110101
1000010000010010010000001
1111010001110110010111001
1000010000010010010010001
1011111110111010110010001
1010001000100010000010001
1010001000100111111110011
1010001000100010101000001
1010101000100010101011111
1000101000101000101000001
1111101001001111101100101
1000101001001000100000101
1110101110111001101111101
1100000000001000100010001
1101111111001100110111011
1000001000000000000100001
1011101011111011100111101
1111000001100001100001001
1111111111111111111111131