1210101110110111011111011
1001010001001000101000101
1000001010100101000010001
1010100000001000100100101
1000010101010010010001001
0101000100001010100100010
1000010001001000010101010
1001000100100100100010010
1001010000010001000101001
1010100100100100010000101
1000000010001001100101001
0101000001010000001000000
0101001010001010100001101
0100100000100000101010001
1000001000100100000110101
1010100011001001001000010
1010001000010011010010101
1001000010100000000100001
0100100110100100101000001
1010000000001000001001010
1000000101001010111011001
0101000010100101100001001
1000001101011100001111100
1010000000000000001000001
0101001111100110010111130