1211111111111111111111111
1000000100000000000000001
1000000100111111110000001
1010000000000000010000001
1011111000000111111111111
1010001000000000000000001
1010001000000000100000001
1000001111100000111111001
1000111000000000100000001
1000001111111111100000001
1000000000000100000010001
1000111100000100000010001
1000100100000100000010001
1000000100000100111111111
1011111111000100000000001
1000000000000100000010001
1001000000000000000010001
1001001111111111111111111
1001000000000000001000001
1001000001000000000000001
1001111111111001111111011
1000000000000000000100001
1000000111111111111111111
1000000000000000000000001
1111111111111111111111131
