1210101110110111011111011
1001010001001000101000101
1000001010100101000010001
1010100000001000100100101
1000010101010010010001001
0101000100001010100100100
1000010001001000010101000
1001000100100100100010000
1001010000010001000101001
1011100100100100010001001
1001010010001001100101001
0101000001010000001001110
0101011010001010100001001
0100100000100000101010001
1000001000100100000110101
1010110011001001001010100
1010001000010011010010101
1001010010100000000100101
0100100110100100101001001
1010100000001000000001000
1000100101000010101010001
0101110010010100010100101
1000100101000011000101000
1010110000011001101000001
0101001111100110010111130